
NO             rutaa
SO rutab
WE rutac
EA rutad

F 255,205,0
C        0,255,255
111
101
111


        1111111111111111111111111
        1000W00000110000000000001
        1011000001110000000000001
        1001000000000000000000001
111111111011000001110000000000001
111111111011110111111000111111111
11110111101110111000000100011
11110111101111011101010010001
11000000100101011100000010001
10000000000000001100000010001
1000000000000000110101001001
11000001110101011111011110001
11110111 1110101 101111010001
11111111 1111111 111111111111